Enigma-3D
001 001 001 001 001 001 001 001 001 001 001 001 001 001 001 001 001 001 001 001
001 003 003 003 003 003 003 003 003 003 003 003 003 003 003 003 002 002 002 001
001 003 003 003 003 003 003 003 003 003 003 003 003 003 003 003 002 002 002 001
001 003 001 001 001 003 003 003 003 003 003 003 003 003 003 003 002 002 002 001
001 003 001 003 003 003 004 003 003 003 004 003 003 003 003 003 002 002 002 001
001 003 001 003 003 004 004 004 003 004 004 004 003 003 003 003 001 002 002 001
001 003 001 003 003 003 004 003 003 003 004 003 003 003 003 003 001 002 002 001
001 003 001 001 001 003 003 003 003 003 003 003 003 003 003 003 001 002 002 001
001 003 003 003 003 003 003 003 003 003 003 003 003 003 003 003 001 002 002 001
001 003 003 003 003 003 003 003 003 003 003 003 003 003 003 003 001 002 002 001
001 003 003 003 003 003 003 003 003 003 003 003 003 003 003 003 001 002 002 001
001 003 003 003 003 003 003 003 003 003 003 003 003 003 003 003 001 002 002 001
001 001 001 001 001 001 001 001 001 001 001 001 001 001 001 001 001 001 001 001
introduce 14 2 to 1 7
introduce 1 7 to 15 2
end

